1111111111111111111111111111111111
1ECCCCCCCCC00000C00000C0CCCCCCCCC1
1010010100100000101001CCCCCCC10101
1010010010101010001001CCCCCCC10101
1P00000000000000000000001010000001
1111111111111111111111111111111111
