1111111111111111111111111111111111
1E00M00000000000C00000C00000000001
1P10010100100000101001000000010101
1010010010101010001001000000010101
100C00000C00C000M00000001C10M00001
1111111111111111111111111111111111
