11111
1C011
11P11
111E1
11111
